Discipline,Country,Total_Gold_Medals,Total_Silver_Medals,Total_Bronze_Medals,Total_Medals
Athletics,United States of America,541164,568916,457908,1567988
Athletics,Great Britain,158268,151074,158268,467610
Baseball/Softball,United States of America,147069,154611,124443,426123
Athletics,People's Republic of China,183996,154944,87156,426096
Swimming,United States of America,143676,151044,121572,416292
Rowing,United States of America,130104,136776,110088,376968
Athletics,Japan,171882,89124,108222,369228
Athletics,Germany,88440,97284,141504,327228
Athletics,Australia,109820,45220,142120,297160
Athletics,Italy,68940,68940,137880,275760
Basketball,United States of America,87945,92455,74415,254815
Rugby Sevens,United States of America,87906,92414,74382,254702
Water Polo,United States of America,86229,90651,72963,249843
Rowing,Great Britain,82940,79170,82940,245050
Fencing,United States of America,81159,85321,68673,235153
Volleyball,United States of America,81042,85198,68574,234814
Athletics,France,65030,78036,71533,214599
Football,Japan,98253,50946,61863,211062
Hockey,Great Britain,71434,68187,71434,211055
Rowing,People's Republic of China,88806,74784,42066,205656
Swimming,People's Republic of China,88616,74624,41976,205216
Football,United States of America,69420,72980,58740,201140
Baseball/Softball,Japan,91206,47292,57426,195924
Shooting,United States of America,67587,71053,57189,195829
Swimming,ROC,52840,73976,60766,187582
Football,Australia,69275,28525,89650,187450
Shooting,People's Republic of China,80370,67680,38070,186120
Rugby Sevens,Japan,77193,40026,48603,165822
Hockey,Japan,77166,40012,48586,165764
Rowing,Australia,59687,24577,77242,161506
Football,People's Republic of China,67298,56672,31878,155848
Swimming,Great Britain,52360,49980,52360,154700
Hockey,Australia,56712,23352,73392,153456
Athletics,Netherlands,41960,50352,58744,151056
Rugby Sevens,Great Britain,48664,46452,48664,143780
Handball,Japan,66609,34538,41939,143086
Hockey,People's Republic of China,60914,51296,28854,141064
Volleyball,ROC,39060,54684,44919,138663
Sailing,United States of America,47346,49774,40062,137182
Wrestling,United States of America,47268,49692,39996,136956
Fencing,ROC,38160,53424,43884,135468
Swimming,Australia,47872,19712,61952,129536
Swimming,Japan,59697,30954,37587,128238
Athletics,Canada,37324,31992,58652,127968
Football,Great Britain,42812,40866,42812,126490
Water Polo,Japan,57294,29708,36074,123076
Shooting,ROC,34660,48524,39859,123043
Artistic Gymnastics,United States of America,42237,44403,35739,122379
Basketball,Japan,56133,29106,35343,120582
Badminton,People's Republic of China,51072,43008,24192,118272
Fencing,People's Republic of China,50920,42880,24120,117920
Swimming,Italy,29080,29080,58160,116320
Hockey,Netherlands,32060,38472,44884,115416
Volleyball,Japan,52596,27272,33116,112984
Skateboarding,United States of America,38805,40795,32835,112435
Rowing,Netherlands,31140,37368,43596,112104
Canoe Sprint,People's Republic of China,47576,40064,22536,110176
Athletics,Brazil,36701,31458,41944,110103
Water Polo,Australia,40528,16688,52448,109664
Hockey,Germany,29450,32395,47120,108965
Equestrian,United States of America,37167,39073,31449,107689
Diving,United States of America,35490,37310,30030,102830
Tennis,United States of America,35490,37310,30030,102830
Fencing,Japan,47817,24794,30107,102718
Wrestling,ROC,28560,39984,32844,101388
Rugby Sevens,Australia,36873,15183,47718,99774
Canoe Sprint,ROC,27720,38808,31878,98406
Basketball,Australia,36125,14875,46750,97750
Water Polo,People's Republic of China,41078,34592,19458,95128
Athletics,Spain,16527,44072,33054,93653
Fencing,Italy,23400,23400,46800,93600
Cycling Track,Great Britain,31460,30030,31460,92950
Artistic Gymnastics,People's Republic of China,39444,33216,18684,91344
Basketball,People's Republic of China,39444,33216,18684,91344
Volleyball,People's Republic of China,39406,33184,18666,91256
Beach Volleyball,United States of America,30420,31980,25740,88140
Cycling Track,United States of America,30381,31939,25707,88027
Sailing,People's Republic of China,37810,31840,17910,87560
Rugby Sevens,People's Republic of China,37696,31744,17856,87296
Judo,ROC,24300,34020,27945,86265
Handball,ROC,24260,33964,27899,86123
Rowing,Italy,21230,21230,42460,84920
Football,Brazil,28252,24216,32288,84756
Sailing,Great Britain,28578,27279,28578,84435
Wrestling,People's Republic of China,36176,30464,17136,83776
Volleyball,Italy,20820,20820,41640,83280
Artistic Gymnastics,ROC,23440,32816,26956,83212
Athletics,Poland,23752,29690,29690,83132
Handball,France,25180,30216,27698,83094
Athletics,Ukraine,4335,26010,52020,82365
Swimming,Germany,21680,23848,34688,80216
Boxing,United States of America,27105,28495,22935,78535
Golf,United States of America,27027,28413,22869,78309
Weightlifting,United States of America,27027,28413,22869,78309
Water Polo,ROC,21660,30324,24909,76893
Football,New Zealand,26362,22596,26362,75320
Sailing,Japan,35046,18172,22066,75284
Rowing,Germany,20340,22374,32544,75258
Boxing,ROC,20780,29092,23897,73769
Rhythmic Gymnastics,United States of America,25350,26650,21450,73450
Cycling Road,United States of America,25311,26609,21417,73337
Equestrian,Great Britain,24794,23667,24794,73255
Basketball,France,21680,26016,23848,71544
Rugby Sevens,ROC,19920,27888,22908,70716
Judo,Japan,32697,16954,20587,70238
Football,France,20810,24972,22891,68673
Diving,People's Republic of China,29526,24864,13986,68376
Cycling Track,Australia,25092,10332,32472,67896
Boxing,Great Britain,21934,20937,21934,64805
Equestrian,People's Republic of China,27968,23552,13248,64768
Diving,Great Britain,21912,20916,21912,64740
Rowing,ROC,18220,25508,20953,64681
Athletics,ROC,18200,25480,20930,64610
Cycling Track,Germany,17340,19074,27744,64158
Shooting,Australia,23545,9695,30470,63710
Archery,United States of America,21957,23083,18579,63619
Football,Netherlands,17320,20784,24248,62352
Baseball/Softball,Australia,22814,9394,29524,61732
Rowing,Canada,17899,15342,28127,61368
Artistic Swimming,People's Republic of China,26296,22144,12456,60896
3x3 Basketball,People's Republic of China,26258,22112,12438,60808
Shooting,Japan,28107,14574,17697,60378
Equestrian,Japan,28026,14532,17646,60204
Fencing,France,18220,21864,20042,60126
Football,Germany,16020,17622,25632,59274
Shooting,Italy,14720,14720,29440,58880
Table Tennis,United States of America,20241,21279,17127,58647
Cycling Track,ROC,16460,23044,18929,58433
Hockey,Spain,10272,27392,20544,58208
Diving,Japan,26919,13958,16949,57826
Artistic Gymnastics,Japan,26919,13958,16949,57826
Canoe Sprint,Australia,21301,8771,27566,57638
Handball,Brazil,19096,16368,21824,57288
Badminton,Japan,25731,13342,16201,55274
Wrestling,Japan,25731,13342,16201,55274
Cycling Mountain Bike,United States of America,18603,19557,15741,53901
Baseball/Softball,Italy,13450,13450,26900,53800
Hockey,New Zealand,18809,16122,18809,53740
Weightlifting,People's Republic of China,23066,19424,10926,53416
Boxing,People's Republic of China,23066,19424,10926,53416
Rugby Sevens,Canada,15477,13266,24321,53064
Canoe Sprint,Germany,14330,15763,22928,53021
Swimming,France,16060,19272,17666,52998
Skateboarding,Japan,24597,12754,15487,52838
Tennis,Japan,24597,12754,15487,52838
Tennis,ROC,14740,20636,16951,52327
Rhythmic Gymnastics,ROC,14700,20580,16905,52185
Football,Canada,14546,12468,22858,49872
Handball,Netherlands,13850,16620,19390,49860
Sailing,Australia,18394,7574,23804,49772
Handball,Germany,13440,14784,21504,49728
Table Tennis,People's Republic of China,21394,18016,10134,49544
3x3 Basketball,ROC,13880,19432,15962,49274
Triathlon,United States of America,16926,17794,14322,49042
Badminton,United States of America,16887,17753,14289,48929
Cycling BMX Freestyle,United States of America,16887,17753,14289,48929
Volleyball,Brazil,15764,13512,18016,47292
Handball,Spain,8334,22224,16668,47226
Rowing,New Zealand,16387,14046,16387,46820
Artistic Swimming,ROC,12980,18172,14927,46079
Sailing,France,13880,16656,15268,45804
Athletics,Jamaica,20268,5067,20268,45603
Archery,People's Republic of China,19684,16576,9324,45584
Swimming,Netherlands,12570,15084,17598,45252
Artistic Gymnastics,Great Britain,15290,14595,15290,45175
Water Polo,Italy,11290,11290,22580,45160
Swimming,Canada,13034,11172,20482,44688
Judo,France,13450,16140,14795,44385
Rugby Sevens,New Zealand,15484,13272,15484,44240
Water Polo,Hungary,13260,15470,15470,44200
Judo,United States of America,15249,16031,12903,44183
Surfing,United States of America,15249,16031,12903,44183
Cycling Track,Italy,10840,10840,21680,43360
Basketball,Germany,11670,12837,18672,43179
Karate,Japan,19845,10290,12495,42630
3x3 Basketball,Japan,19845,10290,12495,42630
Badminton,Great Britain,14300,13650,14300,42250
Cycling Track,People's Republic of China,18088,15232,8568,41888
Tennis,Australia,15453,6363,19998,41814
Basketball,Spain,7284,19424,14568,41276
Baseball/Softball,Republic of Korea,12246,8164,20410,40820
Water Polo,Spain,7158,19088,14316,40562
Water Polo,Netherlands,11240,13488,15736,40464
Canoe Sprint,Japan,18765,9730,11815,40310
Artistic Swimming,Japan,18684,9688,11764,40136
Sailing,ROC,11260,15764,12949,39973
Equestrian,Australia,14739,6069,19074,39882
Hockey,Canada,11522,9876,18106,39504
Sport Climbing,United States of America,13533,14227,11451,39211
3x3 Basketball,United States of America,13533,14227,11451,39211
Karate,United States of America,13494,14186,11418,39098
Swimming,Hungary,11712,13664,13664,39040
Cycling BMX Racing,United States of America,13416,14104,11352,38872
Volleyball,France,11710,14052,12881,38643
Cycling Track,France,11710,14052,12881,38643
Rowing,France,11700,14040,12870,38610
Equestrian,France,11700,14040,12870,38610
Cycling Road,Italy,9550,9550,19100,38200
Rhythmic Gymnastics,People's Republic of China,16492,13888,7812,38192
Judo,People's Republic of China,16416,13824,7776,38016
Tennis,People's Republic of China,16378,13792,7758,37928
Taekwondo,People's Republic of China,16340,13760,7740,37840
Weightlifting,Japan,17550,9100,11050,37700
Sailing,Netherlands,10400,12480,14560,37440
Equestrian,ROC,10420,14588,11983,36991
Diving,ROC,10400,14560,11960,36920
Beach Volleyball,ROC,10400,14560,11960,36920
Equestrian,Germany,9950,10945,15920,36815
Sailing,Italy,9090,9090,18180,36360
Cycling Road,Australia,13277,5467,17182,35926
Cycling Track,Japan,16416,8512,10336,35264
Judo,Germany,9510,10461,15216,35187
Athletics,Kenya,14048,14048,7024,35120
Rhythmic Gymnastics,Japan,16335,8470,10285,35090
Athletics,Switzerland,8067,10756,16134,34957
Football,Republic of Korea,10410,6940,17350,34700
Canoe Sprint,Hungary,10404,12138,12138,34680
Basketball,Italy,8660,8660,17320,34640
Shooting,France,10420,12504,11462,34386
Rugby Sevens,France,10420,12504,11462,34386
Equestrian,Netherlands,9520,11424,13328,34272
Marathon Swimming,United States of America,11778,12382,9966,34126
Athletics,Hungary,10134,11823,11823,33780
Swimming,Brazil,11228,9624,12832,33684
Judo,Italy,8250,8250,16500,33000
Artistic Swimming,Italy,8250,8250,16500,33000
Fencing,Republic of Korea,9888,6592,16480,32960
Artistic Swimming,Australia,11798,4858,15268,31924
Athletics,Turkey,4852,4852,21834,31538
Basketball,Canada,9114,7812,14322,31248
Cycling Track,Canada,9114,7812,14322,31248
Cycling Track,Netherlands,8660,10392,12124,31176
Judo,Netherlands,8640,10368,12096,31104
Judo,Great Britain,10516,10038,10516,31070
Shooting,Great Britain,10516,10038,10516,31070
Archery,Great Britain,10494,10017,10494,31005
Triathlon,Great Britain,10472,9996,10472,30940
Taekwondo,Great Britain,10450,9975,10450,30875
Trampoline Gymnastics,People's Republic of China,13186,11104,6246,30536
Tennis,Germany,8230,9053,13168,30451
Golf,People's Republic of China,13148,11072,6228,30448
Modern Pentathlon,People's Republic of China,13148,11072,6228,30448
Sailing,Germany,8220,9042,13152,30414
Table Tennis,Japan,14094,7308,8874,30276
Beach Volleyball,People's Republic of China,13072,11008,6192,30272
Baseball/Softball,Canada,8820,7560,13860,30240
Archery,Japan,14067,7294,8857,30218
Boxing,Japan,14067,7294,8857,30218
Canoe Sprint,Canada,8792,7536,13816,30144
Water Polo,Canada,8792,7536,13816,30144
Athletics,Czech Republic,10916,10916,8187,30019
Rhythmic Gymnastics,Italy,7370,7370,14740,29480
Football,Spain,5199,13864,10398,29461
Cycling Track,New Zealand,10311,8838,10311,29460
Fencing,Germany,7800,8580,12480,28860
Shooting,Republic of Korea,8598,5732,14330,28660
Tennis,France,8680,10416,9548,28644
Modern Pentathlon,Great Britain,9548,9114,9548,28210
Cycling Road,Great Britain,9504,9072,9504,28080
Tennis,Great Britain,9504,9072,9504,28080
Cycling Road,Netherlands,7780,9336,10892,28008
Rhythmic Gymnastics,Australia,10319,4249,13354,27922
Diving,Australia,10302,4242,13332,27876
Taekwondo,ROC,7820,10948,8993,27761
Sailing,Brazil,9107,7806,10408,27321
Shooting,Germany,7370,8107,11792,27269
Cycling Road,Germany,7370,8107,11792,27269
Canoe Sprint,France,8250,9900,9075,27225
Artistic Gymnastics,Germany,7350,8085,11760,27195
Volleyball,Canada,7868,6744,12364,26976
Judo,Republic of Korea,8076,5384,13460,26920
Handball,Republic of Korea,8070,5380,13450,26900
Canoe Slalom,People's Republic of China,11552,9728,5472,26752
Rowing,Poland,7444,9305,9305,26054
Fencing,Canada,7581,6498,11913,25992
Table Tennis,Australia,9571,3941,12386,25898
Golf,Great Britain,8580,8190,8580,25350
Weightlifting,Great Britain,8580,8190,8580,25350
Handball,Hungary,7536,8792,8792,25120
Triathlon,ROC,6960,9744,8004,24708
Athletics,Cuba,11529,4941,8235,24705
Trampoline Gymnastics,ROC,6920,9688,7958,24566
Rugby Sevens,Brazil,8183,7014,9352,24549
Judo,Brazil,8183,7014,9352,24549
Skateboarding,Brazil,8183,7014,9352,24549
Cycling Road,ROC,6900,9660,7935,24495
Trampoline Gymnastics,United States of America,8424,8856,7128,24408
Artistic Swimming,United States of America,8424,8856,7128,24408
Diving,Italy,6070,6070,12140,24280
Equestrian,Italy,6060,6060,12120,24240
Karate,Italy,6060,6060,12120,24240
Wrestling,Germany,6490,7139,10384,24013
Diving,Germany,6490,7139,10384,24013
Handball,Sweden,7929,15858,0,23787
Artistic Gymnastics,France,6940,8328,7634,22902
Handball,Norway,11444,5722,5722,22888
Canoe Sprint,Great Britain,7656,7308,7656,22620
Cycling Road,Japan,10530,5460,6630,22620
Beach Volleyball,Italy,5640,5640,11280,22560
Athletics,New Zealand,7868,6744,7868,22480
Sailing,Spain,3897,10392,7794,22083
Triathlon,Australia,8109,3339,10494,21942
Weightlifting,Australia,8092,3332,10472,21896
Rugby Sevens,Republic of Korea,6516,4344,10860,21720
Volleyball,Republic of Korea,6510,4340,10850,21700
Fencing,Hungary,6504,7588,7588,21680
Modern Pentathlon,ROC,6080,8512,6992,21584
Archery,ROC,6080,8512,6992,21584
Cycling BMX Racing,ROC,6060,8484,6969,21513
Hockey,India,3029,6058,12116,21203
Athletics,Belarus,2991,8973,8973,20937
Athletics,Belgium,8955,2985,8955,20895
Artistic Gymnastics,Italy,5220,5220,10440,20880
Tennis,Italy,5210,5210,10420,20840
Table Tennis,Germany,5630,6193,9008,20831
Basketball,Republic of Korea,6246,4164,10410,20820
Beach Volleyball,Germany,5620,6182,8992,20794
Diving,Canada,6048,5184,9504,20736
Beach Volleyball,Netherlands,5630,6756,7882,20268
Sport Climbing,Japan,9396,4872,5916,20184
Golf,Japan,9396,4872,5916,20184
Beach Volleyball,Japan,9369,4858,5899,20126
Triathlon,Japan,9369,4858,5899,20126
Trampoline Gymnastics,Japan,9342,4844,5882,20068
Cycling Road,France,6080,7296,6688,20064
Taekwondo,Japan,9315,4830,5865,20010
Rugby Sevens,Kenya,7988,7988,3994,19970
Badminton,Republic of Korea,5982,3988,9970,19940
Skateboarding,Australia,7361,3031,9526,19918
Beach Volleyball,Australia,7361,3031,9526,19918
Sailing,Canada,5768,4944,9064,19776
Canoe Slalom,Great Britain,6666,6363,6666,19695
Canoe Slalom,United States of America,6747,7093,5709,19549
Taekwondo,United States of America,6747,7093,5709,19549
Modern Pentathlon,United States of America,6747,7093,5709,19549
Canoe Sprint,Spain,3384,9024,6768,19176
Triathlon,Italy,4760,4760,9520,19040
Artistic Gymnastics,Netherlands,5170,6204,7238,18612
Triathlon,France,5640,6768,6204,18612
Table Tennis,France,5640,6768,6204,18612
Badminton,ROC,5200,7280,5980,18460
Table Tennis,ROC,5200,7280,5980,18460
Football,Sweden,6111,12222,0,18333
Sailing,New Zealand,6363,5454,6363,18180
Canoe Sprint,Ukraine,953,5718,11436,18107
Badminton,Australia,6630,2730,8580,17940
Rowing,Japan,8181,4242,5151,17574
Athletics,Sweden,5850,11700,0,17550
Canoe Slalom,Japan,8154,4228,5134,17516
Cycling Mountain Bike,Italy,4340,4340,8680,17360
Canoe Sprint,Italy,4330,4330,8660,17320
Equestrian,Brazil,5768,4944,6592,17304
Boxing,France,5210,6252,5731,17193
Cycling BMX Racing,Netherlands,4760,5712,6664,17136
Table Tennis,Great Britain,5742,5481,5742,16965
Badminton,Canada,4844,4152,7612,16608
Wrestling,Ukraine,868,5208,10416,16492
Athletics,India,2338,4676,9352,16366
Volleyball,Turkey,2516,2516,11322,16354
Wrestling,Cuba,7581,3249,5415,16245
Cycling Mountain Bike,Germany,4340,4774,6944,16058
Badminton,Germany,4330,4763,6928,16021
Taekwondo,Australia,5899,2429,7634,15962
Golf,Australia,5899,2429,7634,15962
Boxing,Australia,5899,2429,7634,15962
Surfing,Australia,5882,2422,7612,15916
Athletics,Denmark,4299,5732,5732,15763
Cycling BMX Racing,France,4770,5724,5247,15741
Golf,Italy,3910,3910,7820,15640
Swimming,Republic of Korea,4692,3128,7820,15640
3x3 Basketball,Italy,3900,3900,7800,15600
Marathon Swimming,ROC,4340,6076,4991,15407
Sport Climbing,People's Republic of China,6574,5536,3114,15224
Karate,People's Republic of China,6574,5536,3114,15224
Skateboarding,People's Republic of China,6536,5504,3096,15136
Cycling Road,People's Republic of China,6536,5504,3096,15136
Cycling Mountain Bike,People's Republic of China,6536,5504,3096,15136
Surfing,Japan,7020,3640,4420,15080
Modern Pentathlon,Japan,6993,3626,4403,15022
Handball,Denmark,4035,5380,5380,14795
Artistic Swimming,Ukraine,777,4662,9324,14763
Equestrian,New Zealand,5166,4428,5166,14760
Artistic Gymnastics,Spain,2604,6944,5208,14756
Equestrian,Canada,4256,3648,6688,14592
Artistic Swimming,Canada,4249,3642,6677,14568
Cycling Road,Canada,4249,3642,6677,14568
Canoe Slalom,Germany,3900,4290,6240,14430
Karate,Germany,3900,4290,6240,14430
Marathon Swimming,Germany,3890,4279,6224,14393
Rowing,Romania,3597,10791,0,14388
Athletics,Ethiopia,3595,3595,7190,14380
Skateboarding,France,4350,5220,4785,14355
Modern Pentathlon,France,4340,5208,4774,14322
Surfing,France,4340,5208,4774,14322
Archery,France,4330,5196,4763,14289
Cycling BMX Freestyle,Great Britain,4752,4536,4752,14040
Tennis,Netherlands,3890,4668,5446,14004
Judo,Australia,5168,2128,6688,13984
3x3 Basketball,Netherlands,3880,4656,5432,13968
Archery,Netherlands,3880,4656,5432,13968
Archery,Italy,3470,3470,6940,13880
Baseball/Softball,Mexico,0,0,13868,13868
Judo,Hungary,4158,4851,4851,13860
Weightlifting,Italy,3460,3460,6920,13840
Beach Volleyball,Brazil,4543,3894,5192,13629
Volleyball,Poland,3816,4770,4770,13356
Athletics,Republic of Korea,3900,2600,6500,13000
Sport Climbing,France,3910,4692,4301,12903
Golf,Germany,3480,3828,5568,12876
Golf,France,3900,4680,4290,12870
Triathlon,Germany,3470,3817,5552,12839
Modern Pentathlon,Germany,3470,3817,5552,12839
Basketball,Czech Republic,4668,4668,3501,12837
Boxing,Germany,3460,3806,5536,12802
Archery,Germany,3450,3795,5520,12765
Boxing,Brazil,4235,3630,4840,12705
Swimming,Spain,2211,5896,4422,12529
Tennis,Spain,2208,5888,4416,12512
Artistic Swimming,Spain,2208,5888,4416,12512
Artistic Gymnastics,Canada,3640,3120,5720,12480
Cycling Mountain Bike,Netherlands,3440,4128,4816,12384
Swimming,Turkey,1904,1904,8568,12376
Canoe Slalom,ROC,3480,4872,4002,12354
Judo,Ukraine,650,3900,7800,12350
Rhythmic Gymnastics,Ukraine,650,3900,7800,12350
Cycling Mountain Bike,ROC,3460,4844,3979,12283
Sport Climbing,ROC,3460,4844,3979,12283
Weightlifting,ROC,3460,4844,3979,12283
Cycling BMX Freestyle,ROC,3460,4844,3979,12283
Canoe Sprint,New Zealand,4256,3648,4256,12160
Canoe Slalom,Italy,3040,3040,6080,12160
Weightlifting,Republic of Korea,3648,2432,6080,12160
Marathon Swimming,Italy,3030,3030,6060,12120
Canoe Slalom,Australia,4420,1820,5720,11960
Cycling BMX Racing,Australia,4403,1813,5698,11914
Wrestling,Turkey,1824,1824,8208,11856
Table Tennis,Brazil,3934,3372,4496,11802
Judo,Spain,2082,5552,4164,11798
Artistic Gymnastics,Brazil,3927,3366,4488,11781
Athletics,Colombia,0,9356,2339,11695
Badminton,France,3480,4176,3828,11484
Weightlifting,France,3470,4164,3817,11451
Cycling Mountain Bike,France,3470,4164,3817,11451
Weightlifting,Canada,3339,2862,5247,11448
Boxing,Canada,3325,2850,5225,11400
Volleyball,Serbia,3777,1259,6295,11331
Marathon Swimming,Great Britain,3828,3654,3828,11310
Trampoline Gymnastics,Great Britain,3828,3654,3828,11310
Basketball,Serbia,3768,1256,6280,11304
Archery,Republic of Korea,3390,2260,5650,11300
Table Tennis,Republic of Korea,3384,2256,5640,11280
Swimming,New Zealand,3948,3384,3948,11280
Sailing,Turkey,1734,1734,7803,11271
Cycling Mountain Bike,Great Britain,3806,3633,3806,11245
Football,Egypt,1866,1866,7464,11196
Cycling BMX Racing,Great Britain,3784,3612,3784,11180
Rowing,Spain,1953,5208,3906,11067
Swimming,Denmark,2994,3992,3992,10978
Hockey,Belgium,4686,1562,4686,10934
Canoe Sprint,Poland,3120,3900,3900,10920
Cycling Track,Poland,3116,3895,3895,10906
Badminton,Netherlands,3020,3624,4228,10872
Volleyball,Kenya,4344,4344,2172,10860
Baseball/Softball,Dominican Republic,0,6498,4332,10830
Swimming,Ukraine,561,3366,6732,10659
Water Polo,Serbia,3522,1174,5870,10566
Skateboarding,Italy,2610,2610,5220,10440
Taekwondo,Republic of Korea,3126,2084,5210,10420
Athletics,Norway,5208,2604,2604,10416
Skateboarding,Canada,3038,2604,4774,10416
Judo,Canada,3038,2604,4774,10416
Athletics,Ireland,5206,0,5206,10412
Boxing,Cuba,4858,2082,3470,10410
Wrestling,Italy,2600,2600,5200,10400
Sport Climbing,Italy,2600,2600,5200,10400
Artistic Gymnastics,Republic of Korea,3108,2072,5180,10360
Boxing,Italy,2590,2590,5180,10360
Swimming,Poland,2944,3680,3680,10304
Equestrian,Switzerland,2340,3120,4680,10140
Rowing,Switzerland,2340,3120,4680,10140
Cycling BMX Freestyle,Japan,4698,2436,2958,10092
Marathon Swimming,Japan,4698,2436,2958,10092
Marathon Swimming,France,3040,3648,3344,10032
Badminton,Denmark,2730,3640,3640,10010
Hockey,Argentina,0,3334,6668,10002
Rhythmic Gymnastics,Brazil,3332,2856,3808,9996
Modern Pentathlon,Australia,3689,1519,4774,9982
Trampoline Gymnastics,Australia,3689,1519,4774,9982
Archery,Australia,3672,1512,4752,9936
Artistic Gymnastics,Australia,3672,1512,4752,9936
Shooting,Ukraine,521,3126,6252,9899
Diving,Ukraine,520,3120,6240,9880
Canoe Sprint,United States of America,3393,3567,2871,9831
Hockey,South Africa,3254,6508,0,9762
Equestrian,Sweden,3246,6492,0,9738
Weightlifting,Germany,2600,2860,4160,9620
Weightlifting,New Zealand,3339,2862,3339,9540
Tennis,Canada,2737,2346,4301,9384
Water Polo,Croatia,3513,3513,2342,9368
Golf,Canada,2730,2340,4290,9360
Triathlon,Canada,2730,2340,4290,9360
Triathlon,Netherlands,2600,3120,3640,9360
Karate,ROC,2600,3640,2990,9230
Tennis,Brazil,3038,2604,3472,9114
Boxing,Ukraine,477,2862,5724,9063
Triathlon,Spain,1563,4168,3126,8857
Weightlifting,Chinese Taipei,1476,2952,4428,8856
Table Tennis,Chinese Taipei,1474,2948,4422,8844
Cycling Road,Spain,1560,4160,3120,8840
Shooting,India,1256,2512,5024,8792
Golf,Republic of Korea,2610,1740,4350,8700
Sailing,Republic of Korea,2604,1736,4340,8680
Diving,Republic of Korea,2604,1736,4340,8680
Taekwondo,Italy,2170,2170,4340,8680
Table Tennis,Hungary,2604,3038,3038,8680
Football,Mexico,0,0,8664,8664
Triathlon,Hungary,2598,3031,3031,8660
Sailing,Hungary,2598,3031,3031,8660
Wrestling,Hungary,2598,3031,3031,8660
Water Polo,Kazakhstan,0,0,8648,8648
Karate,France,2610,3132,2871,8613
Rowing,Denmark,2343,3124,3124,8591
Diving,France,2600,3120,2860,8580
3x3 Basketball,France,2600,3120,2860,8580
Swimming,Czech Republic,3120,3120,2340,8580
Sailing,Denmark,2340,3120,3120,8580
Canoe Slalom,France,2600,3120,2860,8580
Sailing,Poland,2436,3045,3045,8526
Judo,Cuba,3948,1692,2820,8460
Sport Climbing,Great Britain,2860,2730,2860,8450
Skateboarding,Great Britain,2860,2730,2860,8450
Wrestling,Canada,2422,2076,3806,8304
Canoe Slalom,Canada,2422,2076,3806,8304
Artistic Gymnastics,Ukraine,433,2598,5196,8227
Swimming,Sweden,2733,5466,0,8199
Athletics,South Africa,2726,5452,0,8178
Athletics,Uganda,4076,2038,2038,8152
Equestrian,Spain,1434,3824,2868,8126
Cycling Mountain Bike,Australia,2958,1218,3828,8004
Cycling BMX Freestyle,Australia,2958,1218,3828,8004
Marathon Swimming,Australia,2958,1218,3828,8004
Sport Climbing,Australia,2958,1218,3828,8004
Baseball/Softball,Israel,3988,0,3988,7976
Wrestling,Kazakhstan,0,0,7960,7960
Basketball,Belgium,3384,1128,3384,7896
Boxing,Turkey,1212,1212,5454,7878
Football,Romania,1951,5853,0,7804
Sailing,Sweden,2601,5202,0,7803
Athletics,Chinese Taipei,1300,2600,3900,7800
Shooting,Czech Republic,2772,2772,2079,7623
Canoe Sprint,Belarus,1086,3258,3258,7602
Triathlon,People's Republic of China,3268,2752,1548,7568
Marathon Swimming,People's Republic of China,3268,2752,1548,7568
Athletics,Portugal,1863,1863,3726,7452
Skateboarding,Spain,1302,3472,2604,7378
Karate,Turkey,1128,1128,5076,7332
Cycling Mountain Bike,Switzerland,1692,2256,3384,7332
Artistic Gymnastics,Turkey,1126,1126,5067,7319
Judo,Turkey,1124,1124,5058,7306
Handball,Egypt,1216,1216,4864,7296
Judo,Poland,2084,2605,2605,7294
Cycling Track,Switzerland,1683,2244,3366,7293
Surfing,Brazil,2429,2082,2776,7287
Volleyball,Islamic Republic of Iran,3123,2082,2082,7287
Diving,Brazil,2429,2082,2776,7287
Cycling Mountain Bike,Brazil,2429,2082,2776,7287
Tennis,Poland,2080,2600,2600,7280
Basketball,Islamic Republic of Iran,3120,2080,2080,7280
Athletics,Greece,3638,1819,1819,7276
Beach Volleyball,Canada,2121,1818,3333,7272
Wrestling,Poland,2072,2590,2590,7252
Shooting,Cuba,3346,1434,2390,7170
Canoe Sprint,Cuba,3339,1431,2385,7155
Wrestling,Islamic Republic of Iran,2991,1994,1994,6979
Shooting,Hungary,2088,2436,2436,6960
Judo,Georgia,1734,4335,867,6936
Athletics,Kazakhstan,0,0,6936,6936
Modern Pentathlon,Italy,1730,1730,3460,6920
Swimming,Switzerland,1563,2084,3126,6773
Sailing,Switzerland,1557,2076,3114,6747
Cycling Track,Denmark,1827,2436,2436,6699
Cycling Road,Poland,1912,2390,2390,6692
Rowing,Czech Republic,2428,2428,1821,6677
Beach Volleyball,Spain,1173,3128,2346,6647
Taekwondo,Spain,1170,3120,2340,6630
Canoe Slalom,Spain,1170,3120,2340,6630
Fencing,Ukraine,347,2082,4164,6593
Archery,Ukraine,347,2082,4164,6593
Hockey,Ireland,3296,0,3296,6592
Fencing,Egypt,1085,1085,4340,6510
Cycling BMX Freestyle,Germany,1740,1914,2784,6438
Athletics,Mexico,0,0,6420,6420
Skateboarding,Germany,1730,1903,2768,6401
Triathlon,Brazil,2128,1824,2432,6384
Equestrian,Belgium,2730,910,2730,6370
Boxing,Netherlands,1740,2088,2436,6264
Tennis,Chinese Taipei,1042,2084,3126,6252
Volleyball,Argentina,0,2083,4166,6249
Cycling Mountain Bike,Canada,1820,1560,2860,6240
Boxing,Kazakhstan,0,0,6232,6232
Skateboarding,Netherlands,1730,2076,2422,6228
Archery,Chinese Taipei,1038,2076,3114,6228
Diving,Netherlands,1730,2076,2422,6228
Table Tennis,Canada,1813,1554,2849,6216
Cycling Road,Denmark,1695,2260,2260,6215
Beach Volleyball,Switzerland,1431,1908,2862,6201
Marathon Swimming,Netherlands,1720,2064,2408,6192
Fencing,Poland,1736,2170,2170,6076
Shooting,Poland,1732,2165,2165,6062
Shooting,Egypt,998,998,3992,5988
Water Polo,South Africa,1994,3988,0,5982
Boxing,Spain,1041,2776,2082,5899
Weightlifting,Spain,1035,2760,2070,5865
Basketball,Slovenia,3513,1171,1171,5855
Trampoline Gymnastics,France,1740,2088,1914,5742
Equestrian,Denmark,1563,2084,2084,5731
Equestrian,Czech Republic,2080,2080,1560,5720
Tennis,Czech Republic,2080,2080,1560,5720
Taekwondo,France,1730,2076,1903,5709
Wrestling,France,1730,2076,1903,5709
Badminton,Chinese Taipei,950,1900,2850,5700
Artistic Swimming,France,1720,2064,1892,5676
Fencing,Great Britain,1914,1827,1914,5655
Cycling Road,Switzerland,1302,1736,2604,5642
Artistic Gymnastics,Switzerland,1299,1732,2598,5629
Taekwondo,Turkey,866,866,3897,5629
Football,Argentina,0,1865,3730,5595
Artistic Swimming,Great Britain,1892,1806,1892,5590
Sailing,Norway,2776,1388,1388,5552
Rowing,Norway,2768,1384,1384,5536
Judo,Azerbaijan,0,2346,3128,5474
Beach Volleyball,Poland,1564,1955,1955,5474
Athletics,Ecuador,3640,1820,0,5460
Canoe Sprint,Brazil,1820,1560,2080,5460
Wrestling,Brazil,1820,1560,2080,5460
Volleyball,Dominican Republic,0,3255,2170,5425
Diving,Mexico,0,0,5376,5376
Modern Pentathlon,Hungary,1566,1827,1827,5220
Modern Pentathlon,Republic of Korea,1566,1044,2610,5220
Fencing,"Hong Kong, China",868,1736,2604,5208
Athletics,Croatia,1950,1950,1300,5200
Tennis,Kazakhstan,0,0,5200,5200
Cycling Road,New Zealand,1820,1560,1820,5200
Boxing,Uzbekistan,3117,0,2078,5195
Weightlifting,Cuba,2422,1038,1730,5190
Shooting,Chinese Taipei,864,1728,2592,5184
Triathlon,New Zealand,1813,1554,1813,5180
Golf,Spain,912,2432,1824,5168
Boxing,India,738,1476,2952,5166
Cycling Road,Belgium,2205,735,2205,5145
Canoe Slalom,Switzerland,1173,1564,2346,5083
Football,South Africa,1694,3388,0,5082
Shooting,Turkey,780,780,3510,5070
Swimming,Serbia,1686,562,2810,5058
Shooting,Serbia,1686,562,2810,5058
Cycling BMX Racing,Japan,2349,1218,1479,5046
Triathlon,Switzerland,1164,1552,2328,5044
Cycling Mountain Bike,Japan,2322,1204,1462,4988
Table Tennis,Ukraine,261,1566,3132,4959
Tennis,Ukraine,259,1554,3108,4921
Karate,Ukraine,259,1554,3108,4921
Wrestling,Belarus,695,2085,2085,4865
Wrestling,Georgia,1216,3040,608,4864
Cycling Road,Norway,2432,1216,1216,4864
Handball,Portugal,1215,1215,2430,4860
Equestrian,Poland,1388,1735,1735,4858
3x3 Basketball,Poland,1388,1735,1735,4858
Swimming,Austria,694,694,3470,4858
Wrestling,Azerbaijan,0,2079,2772,4851
Canoe Slalom,Poland,1384,1730,1730,4844
Wrestling,India,692,1384,2768,4844
Taekwondo,Germany,1300,1430,2080,4810
Badminton,Indonesia,954,954,2862,4770
Wrestling,Egypt,782,782,3128,4692
Boxing,Chinese Taipei,780,1560,2340,4680
Artistic Swimming,Egypt,780,780,3120,4680
Volleyball,Venezuela,1168,3504,0,4672
Wrestling,Uzbekistan,2727,0,1818,4545
Weightlifting,Brazil,1512,1296,1728,4536
Badminton,Brazil,1512,1296,1728,4536
Tennis,Croatia,1692,1692,1128,4512
Fencing,Switzerland,1041,1388,2082,4511
Judo,Israel,2252,0,2252,4504
Karate,Kazakhstan,0,0,4496,4496
Judo,Kazakhstan,0,0,4496,4496
Basketball,Nigeria,0,2214,2214,4428
Cycling Mountain Bike,Spain,780,2080,1560,4420
Badminton,Spain,780,2080,1560,4420
Rowing,Ireland,2172,0,2172,4344
Rugby Sevens,Ireland,2172,0,2172,4344
Water Polo,Greece,2168,1084,1084,4336
Judo,Mongolia,0,1084,3252,4336
Sport Climbing,Republic of Korea,1296,864,2160,4320
Handball,Argentina,0,1430,2860,4290
Weightlifting,Poland,1216,1520,1520,4256
Table Tennis,Poland,1216,1520,1520,4256
Athletics,Austria,607,607,3035,4249
Sailing,Austria,607,607,3035,4249
Rhythmic Gymnastics,Azerbaijan,0,1818,2424,4242
Rhythmic Gymnastics,Belarus,605,1815,1815,4235
Cycling BMX Racing,Canada,1218,1044,1914,4176
Taekwondo,Chinese Taipei,694,1388,2082,4164
Rugby Sevens,Fiji,2077,0,2077,4154
Marathon Swimming,Canada,1211,1038,1903,4152
Taekwondo,Canada,1211,1038,1903,4152
Artistic Gymnastics,Chinese Taipei,692,1384,2076,4152
Trampoline Gymnastics,Canada,1211,1038,1903,4152
Sport Climbing,Canada,1211,1038,1903,4152
Cycling Road,Ukraine,217,1302,2604,4123
Cycling Track,Ukraine,216,1296,2592,4104
Swimming,Israel,1996,0,1996,3992
Karate,Australia,1462,602,1892,3956
Cycling BMX Racing,Switzerland,912,1216,1824,3952
Judo,Serbia,1305,435,2175,3915
Boxing,Kenya,1564,1564,782,3910
Judo,Uzbekistan,2346,0,1564,3910
Athletics,Nigeria,0,1953,1953,3906
Athletics,Serbia,1293,431,2155,3879
Golf,Denmark,1044,1392,1392,3828
Canoe Sprint,Denmark,1044,1392,1392,3828
Athletics,Finland,0,0,3820,3820
Cycling Mountain Bike,Denmark,1041,1388,1388,3817
Canoe Slalom,Czech Republic,1388,1388,1041,3817
Canoe Sprint,Czech Republic,1388,1388,1041,3817
Athletics,Georgia,954,2385,477,3816
Athletics,Romania,953,2859,0,3812
Beach Volleyball,Czech Republic,1384,1384,1038,3806
Cycling Road,Czech Republic,1384,1384,1038,3806
Diving,Spain,651,1736,1302,3689
Archery,Spain,651,1736,1302,3689
Archery,Brazil,1218,1044,1392,3654
Swimming,"Hong Kong, China",607,1214,1821,3642
Modern Pentathlon,Poland,1040,1300,1300,3640
Swimming,South Africa,1213,2426,0,3639
Basketball,Argentina,0,1213,2426,3639
Rhythmic Gymnastics,Bulgaria,1818,606,1212,3636
Wrestling,Bulgaria,1818,606,1212,3636
Fencing,Brazil,1211,1038,1384,3633
Shooting,Islamic Republic of Iran,1557,1038,1038,3633
Taekwondo,Brazil,1211,1038,1384,3633
Canoe Slalom,Brazil,1211,1038,1384,3633
Athletics,Israel,1814,0,1814,3628
Cycling BMX Racing,Brazil,1204,1032,1376,3612
Table Tennis,Sweden,1173,2346,0,3519
Judo,Sweden,1173,2346,0,3519
Rugby Sevens,Argentina,0,1172,2344,3516
Boxing,Republic of Korea,1044,696,1740,3480
Canoe Slalom,New Zealand,1218,1044,1218,3480
Marathon Swimming,Hungary,1044,1218,1218,3480
Cycling BMX Racing,Italy,870,870,1740,3480
Surfing,Italy,870,870,1740,3480
Golf,New Zealand,1218,1044,1218,3480
Shooting,Norway,1732,866,866,3464
Wrestling,Mongolia,0,866,2598,3464
Badminton,Hungary,1038,1211,1211,3460
Cycling Mountain Bike,Hungary,1038,1211,1211,3460
Wrestling,Republic of Korea,1038,692,1730,3460
Surfing,New Zealand,1204,1032,1204,3440
Canoe Sprint,Kazakhstan,0,0,3440,3440
Table Tennis,Italy,860,860,1720,3440
Shooting,New Zealand,1204,1032,1204,3440
Cycling Track,Belgium,1434,478,1434,3346
Judo,Austria,478,478,2390,3346
Equestrian,Austria,476,476,2380,3332
Weightlifting,Ukraine,174,1044,2088,3306
Rowing,Ukraine,174,1044,2088,3306
Equestrian,Ukraine,174,1044,2088,3306
Equestrian,Ireland,1648,0,1648,3296
Badminton,Ukraine,173,1038,2076,3287
Boxing,Dominican Republic,0,1956,1304,3260
Athletics,Slovenia,1953,651,651,3255
Rugby Sevens,South Africa,1085,2170,0,3255
Table Tennis,Cuba,1519,651,1085,3255
Surfing,Germany,870,957,1392,3219
Sport Climbing,Germany,870,957,1392,3219
Weightlifting,Netherlands,870,1044,1218,3132
Artistic Swimming,Netherlands,870,1044,1218,3132
Table Tennis,Netherlands,870,1044,1218,3132
Golf,Chinese Taipei,522,1044,1566,3132
Wrestling,Serbia,1044,348,1740,3132
Swimming,Norway,1564,782,782,3128
3x3 Basketball,Serbia,1041,347,1735,3123
Golf,Sweden,1041,2082,0,3123
Tennis,Serbia,1041,347,1735,3123
Triathlon,Norway,1560,780,780,3120
Archery,Canada,910,780,1430,3120
Table Tennis,Egypt,520,520,2080,3120
Judo,Chinese Taipei,520,1040,1560,3120
Weightlifting,Georgia,780,1950,390,3120
Table Tennis,"Hong Kong, China",520,1040,1560,3120
Sailing,Argentina,0,1039,2078,3117
Athletics,Slovakia,779,1558,779,3116
Rhythmic Gymnastics,Egypt,519,519,2076,3114
Swimming,Chinese Taipei,518,1036,1554,3108
Canoe Slalom,Netherlands,860,1032,1204,3096
Golf,Netherlands,860,1032,1204,3096
Fencing,Netherlands,860,1032,1204,3096
Table Tennis,Austria,435,435,2175,3045
Athletics,Dominican Republic,0,1824,1216,3040
Taekwondo,Poland,868,1085,1085,3038
Table Tennis,India,434,868,1736,3038
Rowing,Belarus,434,1302,1302,3038
3x3 Basketball,Belgium,1299,433,1299,3031
Boxing,Belarus,433,1299,1299,3031
Athletics,Uzbekistan,1818,0,1212,3030
Boxing,Colombia,0,2420,605,3025
Swimming,Belarus,430,1290,1290,3010
Shooting,Spain,522,1392,1044,2958
Artistic Swimming,Greece,1476,738,738,2952
Judo,Portugal,737,737,1474,2948
Karate,Spain,519,1384,1038,2941
Marathon Swimming,Spain,519,1384,1038,2941
Cycling Track,Spain,519,1384,1038,2941
Cycling BMX Freestyle,France,870,1044,957,2871
Shooting,Denmark,783,1044,1044,2871
Athletics,Egypt,478,478,1912,2868
Cycling Mountain Bike,Czech Republic,1040,1040,780,2860
Table Tennis,Czech Republic,1040,1040,780,2860
Athletics,Bahamas,2856,0,0,2856
Cycling Road,Turkey,434,434,1953,2821
Shooting,Switzerland,651,868,1302,2821
Archery,Turkey,434,434,1953,2821
Tennis,Switzerland,651,868,1302,2821
Weightlifting,Indonesia,564,564,1692,2820
Shooting,Croatia,1044,1044,696,2784
Sailing,Greece,1388,694,694,2776
Sailing,Croatia,1038,1038,692,2768
Fencing,Islamic Republic of Iran,1173,782,782,2737
Wrestling,Sweden,912,1824,0,2736
Modern Pentathlon,Brazil,910,780,1040,2730
Rowing,Serbia,909,303,1515,2727
Artistic Gymnastics,Belgium,1167,389,1167,2723
Judo,Belgium,1167,389,1167,2723
Swimming,Bulgaria,1305,435,870,2610
Beach Volleyball,Cuba,1218,522,870,2610
Modern Pentathlon,Cuba,1218,522,870,2610
Athletics,Bulgaria,1305,435,870,2610
Swimming,Greece,1302,651,651,2604
Karate,Egypt,434,434,1736,2604
Canoe Sprint,Republic of Korea,780,520,1300,2600
Karate,New Zealand,910,780,910,2600
Taekwondo,New Zealand,910,780,910,2600
Cycling Mountain Bike,New Zealand,910,780,910,2600
Wrestling,Armenia,0,1300,1300,2600
Archery,Hungary,780,910,910,2600
Wrestling,Kyrgyzstan,0,1732,866,2598
Rhythmic Gymnastics,Israel,1298,0,1298,2596
Shooting,Slovakia,649,1298,649,2596
Swimming,Cuba,1211,519,865,2595
Canoe Sprint,Portugal,648,648,1296,2592
Football,Saudi Arabia,0,2556,0,2556
Athletics,Qatar,1648,0,824,2472
Cycling Mountain Bike,Ukraine,130,780,1560,2470
Boxing,Poland,696,870,870,2436
Cycling Road,Austria,348,348,1740,2436
Triathlon,Austria,348,348,1740,2436
Archery,India,348,696,1392,2436
Boxing,Georgia,608,1520,304,2432
Archery,Kazakhstan,0,0,2432,2432
Sailing,Belgium,1041,347,1041,2429
Athletics,Islamic Republic of Iran,1041,694,694,2429
Rowing,Austria,347,347,1735,2429
Karate,Islamic Republic of Iran,1041,694,694,2429
Boxing,Azerbaijan,0,1038,1384,2422
Tennis,Belgium,1038,346,1038,2422
Sailing,India,346,692,1384,2422
Archery,Poland,692,865,865,2422
Cycling Mountain Bike,Poland,688,860,860,2408
Fencing,Czech Republic,868,868,651,2387
Cycling Road,Colombia,0,1908,477,2385
Table Tennis,Serbia,783,261,1305,2349
Swimming,Egypt,391,391,1564,2346
Taekwondo,Egypt,390,390,1560,2340
Boxing,Sweden,780,1560,0,2340
Badminton,"Hong Kong, China",389,778,1167,2334
Canoe Sprint,Serbia,777,259,1295,2331
Sailing,Portugal,564,564,1128,2256
Boxing,Ireland,1126,0,1126,2252
Judo,Switzerland,519,692,1038,2249
Golf,Switzerland,519,692,1038,2249
Tennis,Argentina,0,736,1472,2208
Volleyball,Tunisia,1085,1085,0,2170
Rhythmic Gymnastics,Uzbekistan,1296,0,864,2160
Judo,Slovenia,1296,432,432,2160
Golf,India,304,608,1216,2128
Shooting,Belarus,303,909,909,2121
Karate,Azerbaijan,0,909,1212,2121
Badminton,India,303,606,1212,2121
Triathlon,Belgium,909,303,909,2121
Karate,Canada,609,522,957,2088
Table Tennis,Croatia,783,783,522,2088
Cycling Road,Kazakhstan,0,0,2088,2088
Shooting,Canada,609,522,957,2088
Judo,Croatia,783,783,522,2088
Modern Pentathlon,Egypt,348,348,1392,2088
Cycling Track,Ireland,1042,0,1042,2084
Cycling Track,"Hong Kong, China",347,694,1041,2082
Swimming,Portugal,520,520,1040,2080
Swimming,Ireland,1040,0,1040,2080
Taekwondo,Croatia,780,780,520,2080
Shooting,Kazakhstan,0,0,2080,2080
Wrestling,Romania,519,1557,0,2076
Sailing,Israel,1038,0,1038,2076
Rowing,Croatia,777,777,518,2072
Equestrian,Egypt,345,345,1380,2070
Karate,Chinese Taipei,344,688,1032,2064
Taekwondo,Serbia,651,217,1085,1953
Swimming,Jamaica,868,217,868,1953
Weightlifting,Dominican Republic,0,1170,780,1950
Taekwondo,Cuba,910,390,650,1950
Archery,Indonesia,390,390,1170,1950
Cycling Road,Slovenia,1167,389,389,1945
Artistic Gymnastics,Sweden,648,1296,0,1944
Triathlon,Czech Republic,696,696,522,1914
Judo,Czech Republic,696,696,522,1914
Artistic Gymnastics,Czech Republic,696,696,522,1914
Table Tennis,Portugal,476,476,952,1904
Modern Pentathlon,Czech Republic,692,692,519,1903
Golf,Czech Republic,692,692,519,1903
Golf,Belgium,783,261,783,1827
Taekwondo,Islamic Republic of Iran,783,522,522,1827
Swimming,India,261,522,1044,1827
Cycling Track,Austria,261,261,1305,1827
Tennis,India,261,522,1044,1827
Archery,Belarus,261,783,783,1827
Boxing,Bulgaria,912,304,608,1824
Shooting,Bulgaria,912,304,608,1824
Skateboarding,Poland,520,650,650,1820
Modern Pentathlon,Belarus,260,780,780,1820
Wrestling,Tunisia,910,910,0,1820
Taekwondo,Azerbaijan,0,780,1040,1820
Artistic Swimming,Austria,260,260,1300,1820
Tennis,Belarus,260,780,780,1820
Skateboarding,Belgium,780,260,780,1820
Judo,Belarus,259,777,777,1813
Canoe Slalom,Austria,259,259,1295,1813
Golf,Austria,258,258,1290,1806
Shooting,Brazil,602,516,688,1806
Football,Côte d'Ivoire,0,0,1780,1780
Beach Volleyball,Kenya,696,696,348,1740
Tennis,Hungary,522,609,609,1740
Weightlifting,Uzbekistan,1044,0,696,1740
Boxing,New Zealand,609,522,609,1740
Trampoline Gymnastics,New Zealand,609,522,609,1740
Tennis,New Zealand,609,522,609,1740
Equestrian,Mexico,0,0,1740,1740
Weightlifting,Hungary,522,609,609,1740
Cycling BMX Racing,New Zealand,609,522,609,1740
Rowing,Republic of Korea,522,348,870,1740
Rowing,Hungary,522,609,609,1740
Rhythmic Gymnastics,Hungary,522,609,609,1740
Diving,New Zealand,609,522,609,1740
Cycling Road,Republic of Korea,522,348,870,1740
Cycling Track,Republic of Korea,522,348,870,1740
Tennis,Republic of Korea,522,348,870,1740
Boxing,Hungary,522,609,609,1740
Karate,Republic of Korea,522,348,870,1740
Equestrian,Republic of Korea,522,348,870,1740
Artistic Gymnastics,New Zealand,609,522,609,1740
Karate,Hungary,522,609,609,1740
Artistic Gymnastics,Hungary,522,609,609,1740
Boxing,Croatia,651,651,434,1736
Swimming,Kazakhstan,0,0,1736,1736
Taekwondo,Uzbekistan,1041,0,694,1735
Badminton,Malaysia,0,867,867,1734
Modern Pentathlon,Mexico,0,0,1732,1732
Swimming,Kenya,692,692,346,1730
Canoe Slalom,Slovenia,1038,346,346,1730
Weightlifting,Kazakhstan,0,0,1728,1728
Cycling Road,Hungary,516,602,602,1720
Taekwondo,Hungary,516,602,602,1720
Athletics,Argentina,0,564,1128,1692
Rowing,South Africa,562,1124,0,1686
Marathon Swimming,Ukraine,87,522,1044,1653
Trampoline Gymnastics,Ukraine,87,522,1044,1653
Triathlon,Ukraine,86,516,1032,1634
Canoe Slalom,Ukraine,86,516,1032,1634
Modern Pentathlon,Ukraine,86,516,1032,1634
Judo,Bulgaria,783,261,522,1566
Badminton,Egypt,261,261,1044,1566
Rowing,Greece,782,391,391,1564
Weightlifting,Mexico,0,0,1564,1564
3x3 Basketball,Mongolia,0,391,1173,1564
Golf,Mexico,0,0,1564,1564
Handball,Bahrain,0,1562,0,1562
Equestrian,Chinese Taipei,260,520,780,1560
Canoe Sprint,Slovakia,390,780,390,1560
Sailing,Mexico,0,0,1560,1560
Artistic Gymnastics,Egypt,260,260,1040,1560
Athletics,"Hong Kong, China",260,520,780,1560
Fencing,Tunisia,780,780,0,1560
Canoe Slalom,Chinese Taipei,260,520,780,1560
Canoe Slalom,Slovakia,390,780,390,1560
Boxing,Argentina,0,519,1038,1557
Canoe Sprint,Sweden,519,1038,0,1557
Archery,Mexico,0,0,1552,1552
Tennis,Colombia,0,1216,304,1520
Canoe Sprint,Belgium,651,217,651,1519
Swimming,Belgium,651,217,651,1519
Athletics,Morocco,1516,0,0,1516
Swimming,Slovenia,909,303,303,1515
Rowing,Belgium,648,216,648,1512
Athletics,Azerbaijan,0,648,864,1512
Cycling Road,Belarus,216,648,648,1512
Sport Climbing,Spain,261,696,522,1479
Modern Pentathlon,Spain,261,696,522,1479
Fencing,Spain,261,696,522,1479
Table Tennis,Spain,258,688,516,1462
Wrestling,Denmark,390,520,520,1430
Cycling Track,Czech Republic,520,520,390,1430
Cycling BMX Racing,Denmark,390,520,520,1430
Golf,Ireland,696,0,696,1392
Boxing,Philippines,348,696,348,1392
Modern Pentathlon,Kazakhstan,0,0,1392,1392
Swimming,Georgia,348,870,174,1392
Swimming,Croatia,522,522,348,1392
Table Tennis,Kazakhstan,0,0,1392,1392
Golf,Norway,696,348,348,1392
Artistic Swimming,Kazakhstan,0,0,1392,1392
Artistic Gymnastics,Norway,696,348,348,1392
Weightlifting,Venezuela,347,1041,0,1388
Shooting,Mongolia,0,347,1041,1388
Triathlon,Mexico,0,0,1388,1388
Shooting,Mexico,0,0,1388,1388
Cycling Track,Kazakhstan,0,0,1384,1384
Athletics,Mongolia,0,346,1038,1384
Taekwondo,Kazakhstan,0,0,1384,1384
Equestrian,Portugal,346,346,692,1384
Table Tennis,Romania,346,1038,0,1384
3x3 Basketball,Romania,346,1038,0,1384
Beach Volleyball,Norway,692,346,346,1384
Canoe Sprint,Croatia,519,519,346,1384
Canoe Slalom,Kazakhstan,0,0,1384,1384
Artistic Gymnastics,Croatia,519,519,346,1384
Athletics,Venezuela,346,1038,0,1384
Fencing,Uzbekistan,783,0,522,1305
Canoe Sprint,Egypt,217,217,868,1302
Sailing,Egypt,217,217,868,1302
Sailing,"Hong Kong, China",217,434,651,1302
Judo,Egypt,217,217,868,1302
Boxing,Ecuador,868,434,0,1302
Weightlifting,Bulgaria,651,217,434,1302
Wrestling,Colombia,0,1040,260,1300
Artistic Swimming,Colombia,0,1040,260,1300
Sailing,Slovenia,780,260,260,1300
Weightlifting,Colombia,0,1040,260,1300
Artistic Gymnastics,Uzbekistan,780,0,520,1300
Table Tennis,Slovenia,780,260,260,1300
Taekwondo,Dominican Republic,0,780,520,1300
Athletics,Latvia,649,0,649,1298
Archery,Egypt,216,216,864,1296
Rowing,Cuba,602,258,430,1290
Artistic Gymnastics,Cuba,602,258,430,1290
Cycling Road,Cuba,602,258,430,1290
Athletics,Bahrain,0,1259,0,1259
Golf,Poland,348,435,435,1218
Weightlifting,Austria,174,174,870,1218
Weightlifting,Islamic Republic of Iran,522,348,348,1218
Tennis,Austria,174,174,870,1218
Sport Climbing,Poland,348,435,435,1218
Artistic Swimming,Belarus,174,522,522,1218
Trampoline Gymnastics,Belarus,174,522,522,1218
Swimming,Romania,304,912,0,1216
Boxing,Venezuela,304,912,0,1216
Tennis,Romania,304,912,0,1216
Boxing,Mongolia,0,304,912,1216
Athletics,Estonia,607,0,607,1214
Badminton,Thailand,607,0,607,1214
Table Tennis,Slovakia,303,606,303,1212
Judo,Venezuela,303,909,0,1212
Judo,Romania,303,909,0,1212
Swimming,Mexico,0,0,1212,1212
Boxing,Uganda,606,303,303,1212
Boxing,Mexico,0,0,1212,1212
Equestrian,Israel,606,0,606,1212
Sport Climbing,Austria,173,173,865,1211
Weightlifting,Belarus,173,519,519,1211
Artistic Gymnastics,Azerbaijan,0,519,692,1211
Canoe Sprint,Austria,173,173,865,1211
Boxing,Islamic Republic of Iran,519,346,346,1211
Cycling Track,Belarus,173,519,519,1211
Sailing,Belarus,173,519,519,1211
Cycling Mountain Bike,Belgium,519,173,519,1211
Rowing,India,173,346,692,1211
Equestrian,Belarus,173,519,519,1211
Shooting,Austria,172,172,860,1204
Weightlifting,Belgium,516,172,516,1204
Artistic Gymnastics,Poland,344,430,430,1204
Swimming,Azerbaijan,0,516,688,1204
Boxing,Jamaica,520,130,520,1170
Equestrian,Argentina,0,390,780,1170
Rowing,Sweden,390,780,0,1170
Badminton,Sweden,390,780,0,1170
Archery,Sweden,390,780,0,1170
Triathlon,South Africa,389,778,0,1167
Badminton,Switzerland,261,348,522,1131
Wrestling,Switzerland,261,348,522,1131
Sport Climbing,Switzerland,261,348,522,1131
Fencing,Turkey,174,174,783,1131
Diving,Switzerland,261,348,522,1131
Cycling BMX Freestyle,Switzerland,261,348,522,1131
Modern Pentathlon,Turkey,174,174,783,1131
Weightlifting,Turkey,174,174,783,1131
Karate,Switzerland,261,348,522,1131
Rowing,Turkey,174,174,783,1131
Table Tennis,Switzerland,261,348,522,1131
Weightlifting,Tunisia,564,564,0,1128
Wrestling,Nigeria,0,564,564,1128
Boxing,Jordan,0,564,564,1128
Badminton,Turkey,172,172,774,1118
Archery,Colombia,0,868,217,1085
Swimming,Colombia,0,868,217,1085
Basketball,Puerto Rico,1084,0,0,1084
Rowing,Chinese Taipei,174,348,522,1044
Diving,Egypt,174,174,696,1044
Cycling Road,South Africa,348,696,0,1044
Tennis,Slovakia,261,522,261,1044
Cycling Road,Chinese Taipei,174,348,522,1044
Artistic Gymnastics,Romania,261,783,0,1044
Karate,Venezuela,261,783,0,1044
Swimming,Venezuela,261,783,0,1044
Beach Volleyball,Argentina,0,347,694,1041
Weightlifting,Ecuador,694,347,0,1041
Shooting,Argentina,0,347,694,1041
Archery,Mongolia,0,260,780,1040
Rhythmic Gymnastics,Kazakhstan,0,0,1040,1040
Sailing,Ireland,520,0,520,1040
Golf,Philippines,260,520,260,1040
Fencing,Georgia,260,650,130,1040
Shooting,Thailand,520,0,520,1040
Tennis,Georgia,260,650,130,1040
Artistic Swimming,Israel,520,0,520,1040
Artistic Gymnastics,Israel,520,0,520,1040
Marathon Swimming,Portugal,260,260,520,1040
Karate,Georgia,260,650,130,1040
Trampoline Gymnastics,Egypt,173,173,692,1038
Triathlon,Portugal,259,259,518,1036
Cycling Track,Mexico,0,0,1036,1036
Badminton,Bulgaria,516,172,344,1032
Boxing,Egypt,172,172,688,1032
Tennis,Egypt,172,172,688,1032
Archery,Czech Republic,348,348,261,957
Weightlifting,Czech Republic,348,348,261,957
Table Tennis,Denmark,261,348,348,957
Skateboarding,Denmark,261,348,348,957
Archery,Denmark,261,348,348,957
Wrestling,Czech Republic,348,348,261,957
Sport Climbing,Czech Republic,348,348,261,957
Marathon Swimming,Czech Republic,348,348,261,957
Sailing,Czech Republic,348,348,261,957
Diving,Malaysia,0,477,477,954
Athletics,Kyrgyzstan,0,608,304,912
Sailing,South Africa,304,608,0,912
Golf,South Africa,304,608,0,912
Judo,Ecuador,608,304,0,912
Fencing,India,130,260,520,910
Badminton,Islamic Republic of Iran,390,260,260,910
Canoe Sprint,Islamic Republic of Iran,390,260,260,910
Table Tennis,Islamic Republic of Iran,390,260,260,910
Cycling Road,Azerbaijan,0,390,520,910
Swimming,Islamic Republic of Iran,390,260,260,910
Skateboarding,Austria,130,130,650,910
Fencing,Azerbaijan,0,390,520,910
Taekwondo,Belgium,390,130,390,910
Swimming,Argentina,0,303,606,909
Sport Climbing,Slovenia,522,174,174,870
Cycling BMX Racing,Colombia,0,696,174,870
Equestrian,Dominican Republic,0,522,348,870
Swimming,Dominican Republic,0,522,348,870
Canoe Sprint,Slovenia,522,174,174,870
Diving,Colombia,0,696,174,870
Taekwondo,Colombia,0,696,174,870
Swimming,Indonesia,174,174,522,870
Swimming,Armenia,0,434,434,868
Cycling Road,Portugal,217,217,434,868
Swimming,Mongolia,0,217,651,868
Swimming,Finland,0,0,868,868
Weightlifting,Philippines,217,434,217,868
Table Tennis,Mongolia,0,217,651,868
Artistic Gymnastics,Mexico,0,0,868,868
Swimming,Uganda,434,217,217,868
Rowing,Venezuela,217,651,0,868
Surfing,Portugal,217,217,434,868
Athletics,Botswana,0,0,867,867
Sailing,Finland,0,0,866,866
Modern Pentathlon,Uzbekistan,519,0,346,865
Rowing,Uzbekistan,519,0,346,865
Swimming,Uzbekistan,519,0,346,865
Golf,Colombia,0,692,173,865
Canoe Sprint,Uzbekistan,519,0,346,865
Cycling Road,Uzbekistan,519,0,346,865
Cycling Mountain Bike,Mexico,0,0,864,864
Taekwondo,Mexico,0,0,864,864
Athletics,Indonesia,172,172,516,860
Rowing,Lithuania,0,824,0,824
Shooting,Sweden,261,522,0,783
Karate,Serbia,261,87,435,783
Diving,Jamaica,348,87,348,783
Diving,Sweden,261,522,0,783
Artistic Gymnastics,Jamaica,348,87,348,783
Judo,Jamaica,348,87,348,783
Canoe Slalom,Sweden,261,522,0,783
Boxing,Serbia,261,87,435,783
Tennis,Sweden,261,522,0,783
Table Tennis,Nigeria,0,391,391,782
Fencing,Estonia,391,0,391,782
Golf,"Hong Kong, China",130,260,390,780
Cycling Road,"Hong Kong, China",130,260,390,780
Swimming,Qatar,520,0,260,780
Triathlon,"Hong Kong, China",130,260,390,780
Golf,Thailand,390,0,390,780
Table Tennis,Argentina,0,260,520,780
Cycling Track,South Africa,260,520,0,780
Boxing,Thailand,390,0,390,780
Athletics,Lithuania,0,778,0,778
Golf,Finland,0,0,778,778
Skateboarding,South Africa,259,518,0,777
Cycling Mountain Bike,Sweden,258,516,0,774
Weightlifting,Sweden,258,516,0,774
Skateboarding,Sweden,258,516,0,774
Canoe Sprint,Argentina,0,258,516,774
Athletics,Ghana,0,0,736,736
Cycling Mountain Bike,Norway,348,174,174,696
Karate,Croatia,261,261,174,696
Wrestling,Greece,348,174,174,696
Fencing,Kazakhstan,0,0,696,696
Boxing,Romania,174,522,0,696
Artistic Gymnastics,Kazakhstan,0,0,696,696
Wrestling,Croatia,261,261,174,696
Canoe Slalom,Croatia,261,261,174,696
Badminton,Mexico,0,0,696,696
Sailing,Tunisia,348,348,0,696
Weightlifting,Mongolia,0,174,522,696
Cycling BMX Racing,Norway,348,174,174,696
Artistic Swimming,Mexico,0,0,696,696
Judo,Ireland,348,0,348,696
Shooting,Greece,348,174,174,696
Fencing,Venezuela,174,522,0,696
Swimming,Slovakia,174,348,174,696
Sport Climbing,Kazakhstan,0,0,696,696
Judo,Kosovo,696,0,0,696
Equestrian,Norway,348,174,174,696
Taekwondo,Norway,348,174,174,696
Rhythmic Gymnastics,Georgia,174,435,87,696
Athletics,Philippines,174,348,174,696
Beach Volleyball,Latvia,347,0,347,694
Boxing,Morocco,694,0,0,694
Cycling Road,Slovakia,173,346,173,692
Swimming,Philippines,173,346,173,692
Badminton,Israel,346,0,346,692
Triathlon,Ireland,346,0,346,692
Athletics,Tunisia,346,346,0,692
Boxing,Armenia,0,346,346,692
Judo,Greece,346,173,173,692
Fencing,Romania,173,519,0,692
Diving,Ireland,346,0,346,692
Rowing,Estonia,346,0,346,692
Tennis,Mexico,0,0,692,692
Weightlifting,Armenia,0,346,346,692
Cycling Road,Mexico,0,0,692,692
Cycling Road,Ireland,346,0,346,692
Wrestling,Mexico,0,0,692,692
Cycling Track,Norway,344,172,172,688
Diving,Norway,344,172,172,688
Rowing,Kazakhstan,0,0,688,688
Triathlon,Israel,344,0,344,688
Cycling Road,Croatia,258,258,172,688
Canoe Sprint,Norway,344,172,172,688
Shooting,Georgia,172,430,86,688
Cycling Road,Ecuador,434,217,0,651
Marathon Swimming,Ecuador,434,217,0,651
Golf,Slovenia,390,130,130,650
Sport Climbing,South Africa,216,432,0,648
Diving,South Africa,216,432,0,648
Artistic Gymnastics,Austria,87,87,435,609
Karate,Austria,87,87,435,609
Archery,Belgium,261,87,261,609
Shooting,Belgium,261,87,261,609
Artistic Gymnastics,India,87,174,348,609
Triathlon,Azerbaijan,0,261,348,609
Equestrian,India,87,174,348,609
Judo,India,87,174,348,609
Rowing,Islamic Republic of Iran,261,174,174,609
Canoe Slalom,Belgium,261,87,261,609
Shooting,Azerbaijan,0,261,348,609
Badminton,Azerbaijan,0,261,348,609
Judo,Tunisia,304,304,0,608
3x3 Basketball,Latvia,304,0,304,608
Swimming,Estonia,303,0,303,606
Equestrian,Thailand,303,0,303,606
Cycling Mountain Bike,Austria,86,86,430,602
Cycling Road,Islamic Republic of Iran,258,172,172,602
Badminton,Austria,86,86,430,602
Badminton,Belgium,258,86,258,602
Archery,Islamic Republic of Iran,258,172,172,602
Cycling BMX Racing,Belgium,258,86,258,602
Artistic Gymnastics,Belarus,86,258,258,602
Equestrian,Morocco,564,0,0,564
Karate,Bulgaria,261,87,174,522
Triathlon,Egypt,87,87,348,522
Cycling Mountain Bike,South Africa,174,348,0,522
Swimming,Ecuador,348,174,0,522
Karate,"Hong Kong, China",87,174,261,522
Artistic Gymnastics,Bulgaria,261,87,174,522
Sailing,Malaysia,0,261,261,522
Rowing,"Hong Kong, China",87,174,261,522
Equestrian,"Hong Kong, China",87,174,261,522
Shooting,Finland,0,0,522,522
Rowing,Egypt,87,87,348,522
Judo,Argentina,0,174,348,522
Taekwondo,Portugal,130,130,260,520
Athletics,Armenia,0,260,260,520
Judo,Mexico,0,0,520,520
Shooting,Kuwait,0,0,520,520
Fencing,Mexico,0,0,520,520
Diving,Venezuela,130,390,0,520
Archery,Romania,130,390,0,520
Cycling Road,Ethiopia,130,130,260,520
Shooting,Portugal,130,130,260,520
Trampoline Gymnastics,Portugal,130,130,260,520
Rhythmic Gymnastics,Mexico,0,0,520,520
Modern Pentathlon,Ireland,260,0,260,520
Cycling Road,Venezuela,130,390,0,520
Shooting,Ireland,260,0,260,520
Taekwondo,Philippines,130,260,130,520
Canoe Sprint,Romania,130,390,0,520
Archery,Slovakia,130,260,130,520
Shooting,Tunisia,260,260,0,520
Rowing,Argentina,0,173,346,519
Marathon Swimming,South Africa,173,346,0,519
Artistic Swimming,South Africa,173,346,0,519
Wrestling,Ecuador,344,172,0,516
Marathon Swimming,"Hong Kong, China",86,172,258,516
Artistic Gymnastics,"Hong Kong, China",86,172,258,516
Cycling Track,Egypt,86,86,344,516
Canoe Sprint,Bulgaria,258,86,172,516
Table Tennis,Bulgaria,258,86,172,516
Athletics,Republic of Moldova,0,0,478,478
Shooting,Slovenia,261,87,87,435
Tennis,Uzbekistan,261,0,174,435
Marathon Swimming,Slovenia,261,87,87,435
Trampoline Gymnastics,Colombia,0,348,87,435
Judo,Dominican Republic,0,261,174,435
Skateboarding,Colombia,0,348,87,435
Rowing,Indonesia,87,87,261,435
Cycling Track,Colombia,0,348,87,435
Archery,Slovenia,261,87,87,435
Sailing,Thailand,217,0,217,434
Swimming,Bahamas,434,0,0,434
Badminton,Nigeria,0,217,217,434
Canoe Sprint,Tunisia,217,217,0,434
Artistic Gymnastics,Malaysia,0,217,217,434
Swimming,Latvia,217,0,217,434
Cycling BMX Racing,Latvia,217,0,217,434
Cycling Track,Malaysia,0,216,216,432
Athletics,Puerto Rico,432,0,0,432
Equestrian,Colombia,0,344,86,430
Cycling Mountain Bike,Slovenia,258,86,86,430
Surfing,Indonesia,86,86,258,430
Diving,Dominican Republic,0,258,172,430
Shooting,Indonesia,86,86,258,430
Shooting,Colombia,0,344,86,430
Rhythmic Gymnastics,Slovenia,258,86,86,430
Fencing,Colombia,0,344,86,430
Rowing,Dominican Republic,0,258,172,430
Surfing,South Africa,130,260,0,390
Taekwondo,Côte d'Ivoire,0,0,390,390
Triathlon,Argentina,0,130,260,390
Cycling BMX Racing,Ecuador,260,130,0,390
Shooting,Qatar,260,0,130,390
Surfing,Ecuador,260,130,0,390
Modern Pentathlon,Ecuador,260,130,0,390
Marathon Swimming,Argentina,0,130,260,390
Wrestling,San Marino,0,130,260,390
Triathlon,Ecuador,260,130,0,390
Rowing,Qatar,260,0,130,390
Sailing,Estonia,174,0,174,348
Taekwondo,Ethiopia,87,87,174,348
Archery,Malaysia,0,174,174,348
Artistic Gymnastics,Portugal,87,87,174,348
Archery,Tunisia,174,174,0,348
Shooting,Venezuela,87,261,0,348
Swimming,Ethiopia,87,87,174,348
Marathon Swimming,Mexico,0,0,348,348
Cycling Mountain Bike,Israel,174,0,174,348
Rowing,Mexico,0,0,348,348
Artistic Gymnastics,Slovakia,87,174,87,348
Canoe Slalom,Mexico,0,0,348,348
Badminton,Slovakia,87,174,87,348
Shooting,Romania,87,261,0,348
Weightlifting,Greece,174,87,87,348
Cycling Road,Estonia,174,0,174,348
Weightlifting,Israel,174,0,174,348
Cycling BMX Freestyle,Venezuela,87,261,0,348
Sailing,Venezuela,87,261,0,348
Marathon Swimming,Venezuela,87,261,0,348
Cycling Road,Romania,87,261,0,348
Boxing,Tunisia,174,174,0,348
Judo,Armenia,0,174,174,348
Shooting,Armenia,0,174,174,348
Skateboarding,Philippines,87,174,87,348
Badminton,Ireland,174,0,174,348
Badminton,Estonia,174,0,174,348
Artistic Gymnastics,Greece,174,87,87,348
Wrestling,Slovakia,87,174,87,348
Table Tennis,Tunisia,174,174,0,348
Fencing,Greece,174,87,87,348
Canoe Slalom,Portugal,87,87,174,348
Cycling Mountain Bike,Greece,174,87,87,348
Archery,Greece,174,87,87,348
Rowing,Philippines,87,174,87,348
Triathlon,Romania,87,261,0,348
Athletics,Malaysia,0,174,174,348
Cycling Mountain Bike,Portugal,87,87,174,348
Cycling Track,Portugal,87,87,174,348
Cycling Mountain Bike,Romania,87,261,0,348
Surfing,Israel,174,0,174,348
Athletics,Namibia,0,348,0,348
Trampoline Gymnastics,Mexico,0,0,348,348
Canoe Slalom,Ireland,174,0,174,348
Rowing,Tunisia,174,174,0,348
Rowing,Uganda,174,87,87,348
Rowing,Portugal,87,87,174,348
Artistic Gymnastics,Armenia,0,174,174,348
Marathon Swimming,Greece,174,87,87,348
Athletics,Côte d'Ivoire,0,0,346,346
Wrestling,Estonia,173,0,173,346
Swimming,Malaysia,0,173,173,346
Weightlifting,Latvia,173,0,173,346
Athletics,Thailand,173,0,173,346
Wrestling,Finland,0,0,346,346
Swimming,Kosovo,346,0,0,346
Weightlifting,Turkmenistan,0,346,0,346
Rowing,Thailand,173,0,173,346
Athletics,Grenada,0,0,346,346
Golf,Malaysia,0,173,173,346
Swimming,Lithuania,0,345,0,345
Swimming,Thailand,172,0,172,344
Archery,Israel,172,0,172,344
Beach Volleyball,Mexico,0,0,344,344
Taekwondo,Greece,172,86,86,344
Taekwondo,Israel,172,0,172,344
Cycling Road,Greece,172,86,86,344
Cycling Track,Greece,172,86,86,344
Cycling Road,Israel,172,0,172,344
Shooting,Philippines,86,172,86,344
Golf,Venezuela,86,258,0,344
Artistic Gymnastics,Ireland,172,0,172,344
Tennis,Greece,172,86,86,344
Taekwondo,Thailand,172,0,172,344
Tennis,Portugal,86,86,172,344
Shooting,Israel,172,0,172,344
Marathon Swimming,Israel,172,0,172,344
Taekwondo,Ireland,172,0,172,344
Skateboarding,Portugal,86,86,172,344
Swimming,Fiji,172,0,172,344
Judo,Philippines,86,172,86,344
Table Tennis,Puerto Rico,304,0,0,304
Modern Pentathlon,Lithuania,0,303,0,303
Canoe Sprint,Republic of Moldova,0,0,303,303
Shooting,San Marino,0,87,174,261
Cycling Mountain Bike,Argentina,0,87,174,261
Artistic Gymnastics,South Africa,87,174,0,261
Table Tennis,Ecuador,174,87,0,261
Archery,Ecuador,174,87,0,261
Judo,Qatar,174,0,87,261
Taekwondo,Argentina,0,87,174,261
Swimming,Kyrgyzstan,0,174,87,261
Cycling BMX Racing,South Africa,87,174,0,261
Wrestling,Argentina,0,87,174,261
Weightlifting,Kyrgyzstan,0,174,87,261
Fencing,Argentina,0,87,174,261
Artistic Gymnastics,Argentina,0,87,174,261
Shooting,Kyrgyzstan,0,174,87,261
Taekwondo,Morocco,261,0,0,261
Shooting,Ecuador,174,87,0,261
Judo,Puerto Rico,261,0,0,261
Judo,San Marino,0,87,174,261
Golf,Ecuador,174,87,0,261
Skateboarding,Finland,0,0,260,260
Taekwondo,Nigeria,0,130,130,260
Athletics,Jordan,0,130,130,260
Shooting,Jordan,0,130,130,260
Athletics,Kuwait,0,0,260,260
Swimming,Jordan,0,130,130,260
Taekwondo,Jordan,0,130,130,260
Canoe Sprint,Latvia,130,0,130,260
Weightlifting,Saudi Arabia,0,260,0,260
Judo,Latvia,130,0,130,260
Sailing,Lithuania,0,260,0,260
Athletics,Saudi Arabia,0,260,0,260
Canoe Sprint,Nigeria,0,130,130,260
Equestrian,Jordan,0,130,130,260
Judo,Kyrgyzstan,0,172,86,258
Beach Volleyball,Qatar,172,0,86,258
Canoe Slalom,Argentina,0,86,172,258
Equestrian,South Africa,86,172,0,258
Surfing,Argentina,0,86,172,258
Boxing,Ghana,0,0,258,258
Judo,South Africa,86,172,0,258
Swimming,San Marino,0,86,172,258
Golf,Argentina,0,86,172,258
Modern Pentathlon,Argentina,0,86,172,258
Cycling BMX Racing,Argentina,0,86,172,258
Cycling Road,Argentina,0,86,172,258
Equestrian,Ecuador,172,86,0,258
Swimming,North Macedonia,0,217,0,217
Swimming,Morocco,217,0,0,217
Beach Volleyball,Morocco,217,0,0,217
Wrestling,Republic of Moldova,0,0,217,217
Judo,Saudi Arabia,0,217,0,217
Swimming,Puerto Rico,216,0,0,216
Swimming,Turkmenistan,0,216,0,216
Weightlifting,Republic of Moldova,0,0,216,216
Swimming,Bahrain,0,216,0,216
Judo,Morocco,174,0,0,174
Wrestling,Latvia,87,0,87,174
Swimming,Nigeria,0,87,87,174
Shooting,Latvia,87,0,87,174
Karate,Latvia,87,0,87,174
Shooting,Estonia,87,0,87,174
Swimming,Kuwait,0,0,174,174
Swimming,Tunisia,87,87,0,174
Archery,Republic of Moldova,0,0,174,174
Boxing,Botswana,0,0,174,174
Sailing,Fiji,87,0,87,174
Marathon Swimming,Tunisia,87,87,0,174
Shooting,Malaysia,0,87,87,174
Athletics,Kosovo,174,0,0,174
Tennis,Estonia,87,0,87,174
Swimming,Grenada,0,0,174,174
Judo,Jordan,0,87,87,174
Equestrian,Latvia,87,0,87,174
Tennis,Latvia,87,0,87,174
Cycling Mountain Bike,Estonia,87,0,87,174
Cycling Track,Lithuania,0,174,0,174
Cycling BMX Racing,Thailand,87,0,87,174
Swimming,Burkina Faso,0,0,174,174
Equestrian,Estonia,87,0,87,174
Cycling Road,Thailand,87,0,87,174
Judo,Estonia,87,0,87,174
Tennis,Tunisia,87,87,0,174
Artistic Gymnastics,Nigeria,0,87,87,174
Triathlon,Estonia,87,0,87,174
Badminton,Finland,0,0,174,174
Archery,Estonia,87,0,87,174
Sailing,Puerto Rico,174,0,0,174
Taekwondo,Tunisia,87,87,0,174
Shooting,Kosovo,174,0,0,174
Cycling Road,Namibia,0,174,0,174
Cycling Mountain Bike,Namibia,0,173,0,173
Swimming,Ghana,0,0,173,173
Cycling Road,Lithuania,0,173,0,173
Canoe Slalom,Morocco,173,0,0,173
Athletics,Burkina Faso,0,0,173,173
Judo,Thailand,86,0,86,172
Table Tennis,Thailand,86,0,86,172
Canoe Sprint,Thailand,86,0,86,172
Archery,Finland,0,0,172,172
Table Tennis,Fiji,86,0,86,172
Swimming,Republic of Moldova,0,0,172,172
Equestrian,Finland,0,0,172,172
Rowing,Nigeria,0,86,86,172
Cycling Road,Latvia,86,0,86,172
Boxing,Kosovo,172,0,0,172
Wrestling,Kosovo,172,0,0,172
Judo,Republic of Moldova,0,0,172,172
Athletics,Fiji,86,0,86,172
Modern Pentathlon,Latvia,86,0,86,172
Judo,Fiji,86,0,86,172
Table Tennis,Saudi Arabia,0,130,0,130
Shooting,North Macedonia,0,130,0,130
Swimming,Saudi Arabia,0,130,0,130
Shooting,Saudi Arabia,0,130,0,130
Equestrian,Puerto Rico,130,0,0,130
Karate,Kuwait,0,0,130,130
Surfing,Morocco,130,0,0,130
Weightlifting,Ghana,0,0,130,130
Wrestling,Morocco,130,0,0,130
Judo,Ghana,0,0,130,130
Weightlifting,Syrian Arab Republic,0,0,130,130
Rowing,Kuwait,0,0,130,130
Golf,Puerto Rico,130,0,0,130
Rowing,Saudi Arabia,0,130,0,130
Judo,Turkmenistan,0,130,0,130
Rowing,Bermuda,130,0,0,130
Shooting,Republic of Moldova,0,0,87,87
Swimming,Botswana,0,0,87,87
Fencing,Morocco,87,0,0,87
Triathlon,Morocco,87,0,0,87
Taekwondo,North Macedonia,0,87,0,87
Shooting,Morocco,87,0,0,87
Rowing,Namibia,0,87,0,87
Athletics,Turkmenistan,0,87,0,87
Judo,Burkina Faso,0,0,87,87
Skateboarding,Puerto Rico,87,0,0,87
Wrestling,Lithuania,0,87,0,87
Canoe Sprint,Lithuania,0,87,0,87
Rowing,Morocco,87,0,0,87
Karate,Saudi Arabia,0,87,0,87
Triathlon,Bermuda,87,0,0,87
Weightlifting,Morocco,87,0,0,87
Equestrian,Syrian Arab Republic,0,0,87,87
Wrestling,Puerto Rico,87,0,0,87
Swimming,Syrian Arab Republic,0,0,87,87
Shooting,Puerto Rico,87,0,0,87
Cycling Road,Burkina Faso,0,0,87,87
Boxing,Bahrain,0,87,0,87
Athletics,Syrian Arab Republic,0,0,87,87
Shooting,Lithuania,0,87,0,87
Triathlon,Syrian Arab Republic,0,0,87,87
Diving,Puerto Rico,87,0,0,87
Judo,Lithuania,0,87,0,87
Golf,Morocco,87,0,0,87
Weightlifting,Botswana,0,0,87,87
Boxing,Namibia,0,87,0,87
Rowing,Côte d'Ivoire,0,0,87,87
Cycling Road,Morocco,87,0,0,87
Wrestling,North Macedonia,0,87,0,87
Karate,North Macedonia,0,87,0,87
Shooting,Bahrain,0,87,0,87
Boxing,Puerto Rico,86,0,0,86
Judo,North Macedonia,0,86,0,86
Artistic Gymnastics,Lithuania,0,86,0,86
Rowing,Puerto Rico,86,0,0,86
Table Tennis,Syrian Arab Republic,0,0,86,86
Marathon Swimming,Namibia,0,86,0,86
Taekwondo,Burkina Faso,0,0,86,86
Taekwondo,Puerto Rico,86,0,0,86
Athletics,North Macedonia,0,86,0,86
Karate,Morocco,86,0,0,86
Weightlifting,Lithuania,0,86,0,86
Swimming,Côte d'Ivoire,0,0,86,86
Swimming,NULL,NULL,NULL,NULL,NULL
Skateboarding,NULL,NULL,NULL,NULL,NULL
Cycling Track,NULL,NULL,NULL,NULL,NULL
Cycling Road,NULL,NULL,NULL,NULL,NULL
Rowing,NULL,NULL,NULL,NULL,NULL
Handball,NULL,NULL,NULL,NULL,NULL
Sailing,NULL,NULL,NULL,NULL,NULL
Diving,NULL,NULL,NULL,NULL,NULL
Taekwondo,NULL,NULL,NULL,NULL,NULL
Rhythmic Gymnastics,NULL,NULL,NULL,NULL,NULL
Modern Pentathlon,NULL,NULL,NULL,NULL,NULL
Boxing,NULL,NULL,NULL,NULL,NULL
Wrestling,NULL,NULL,NULL,NULL,NULL
Artistic Swimming,NULL,NULL,NULL,NULL,NULL
Fencing,NULL,NULL,NULL,NULL,NULL
Golf,NULL,NULL,NULL,NULL,NULL
Artistic Gymnastics,NULL,NULL,NULL,NULL,NULL
Athletics,NULL,NULL,NULL,NULL,NULL
Judo,NULL,NULL,NULL,NULL,NULL
Cycling BMX Freestyle,NULL,NULL,NULL,NULL,NULL
Surfing,NULL,NULL,NULL,NULL,NULL
Marathon Swimming,NULL,NULL,NULL,NULL,NULL
Equestrian,NULL,NULL,NULL,NULL,NULL
Beach Volleyball,NULL,NULL,NULL,NULL,NULL
Archery,NULL,NULL,NULL,NULL,NULL
Canoe Sprint,NULL,NULL,NULL,NULL,NULL
Football,NULL,NULL,NULL,NULL,NULL
Cycling Mountain Bike,NULL,NULL,NULL,NULL,NULL
Weightlifting,NULL,NULL,NULL,NULL,NULL
Water Polo,NULL,NULL,NULL,NULL,NULL
Badminton,NULL,NULL,NULL,NULL,NULL
Shooting,NULL,NULL,NULL,NULL,NULL
Karate,NULL,NULL,NULL,NULL,NULL
Canoe Slalom,NULL,NULL,NULL,NULL,NULL
Table Tennis,NULL,NULL,NULL,NULL,NULL
Triathlon,NULL,NULL,NULL,NULL,NULL
